NO          ./textures/yin.xpm
SO          ./textures/dragon.xpm
WE          ./textures/monster.xpm
EA          ./textures/house.xpm

C       98,175,225
F       12,45,154


            1111111111111111111111111
            1000000000110000000000001
            1011000001110000001610001
           11001000000000000000S00001
111111111110000011100000000000011111
1000000000110000011101611111111111
11110111111111011100000000001
11110111111111011101010010001
11000000110101011100000010001
10000001610000000011000000101
10000000000000001101010011111
1016100111010101111101111101111
10000111 11101011101111011111
11111111 1111111 111111111111