NO          ../parsing/fill_map.c
SO          ../parsing/parse_fill.c
WE          ../parsing/parsing.c 
EA          ../parsing/parsing.h

C       55,125,206
F       255,255,2



            1111111111111111111111111
            1000000000110000000000001
            1011000001110000000000001
           11001000000000000000000001
111111111110000011100000000000011111
100000000011000001110111111111111
11110111111111011100000010001
11110111111111011101010010001
11000000110101011100000010001
10000000000000001100000010001
10000000000000001101010010001
111111111111111111111111W0111
11110111 11101011101111010001
11111111 1111111 111111111111
1111111111100000111000000001111
100000000011000001110111111111111
11110111111111011100000010001
11110111111111011101010010001
11000000110101011100000010001
10000000000000001100000010001
10000000000000001101010010001
11111111111111111111111100111
11110111 11101011101111010001
11111111 1111111 111111111111
11111111 1111111 111111111111
1111111111100000111000000001111
100000000011000001110111111111111
11110111111111011100000010001
11110111111111011101010010001
11000000110101011100000010001
10000000000000001100000010001
10000000000000001101010010001
11111111111111111111111100111
11110111 11101011101111010001
11111111 1111111 111111111111