NO  parsing_utils.c
SO parsing.h
WE parse_fill.c
EA Makefile

F          132 , 1 , 2
C          225 , 30 , 132


1111111111111111111111111
1000000000110000000000001
101100000111000000000001
1001000000000000000000001
1111111101100000111000001
100000000011000001110111111111111
11110111111111011100000010001
11110111111111011101010010001
1100000110101011100000010001
10000000000000001100000010001
10000000000000001101010010001
1100000111010101111101111N00111
11110111 1110101 101111010001
11111111 1111111 111111111111