NO fill_map.c
SO parse_fill.c
WE parsing.c
EA Makefile

F 220,100,0
C 225,30,0

111111      
10 011 
101111
1N0001
111111