12121113
dkdldlkf
klklkl
eewew56565565



11111
22222
33333
44444

55555
66666