NO          ../textures/yin.xpm
SO          ../textures/dragon.xpm
WE          ../textures/monster.xpm
EA          ../textures/house.xpm

C       98,175,225
F       12,45,154


            1111111111111111111111111
            10000N0000110000000000001
            1011000001110000000000001
           11001000000000000000000001
111111111110000011100000000000011111
100000000011000001110111111111111
11110111111111011100000010001
11110111111111011101010010001
11000000110101011100000010001
10000000000000001100000010001
10000000000000001101010011111
1100000111010101111101111101111
11110111 11101011101111011111
11111111 1111111 111111111111