NO          ./textures/yin.xpm
SO          ./textures/dragon.xpm
WE          ./textures/monster.xpm
EA          ./textures/house.xpm

C       98,175,225
F       12,45,154


1111111111111111111111111111111111111111111
1000000000010000000000100000100010001000001
1000000000010000000000100000100010001000001
1000000000010000000000100000100010001000001
1000000000010000000000100000100010006000001
1000000000010000000000100000100010001000001
1000000000010000000000100000100010001000001
1000000000010000000000100000100010001000001
1000000000010000000000100000100010001000001
1000000000060000000000100000100060001000001
100000000001000000000060000010001000100W001
1000000000010000000000100000600010006000001
1000000000010000000000100000100010001000001
1000000000010000000000100000100010001000001
1000000000010000000000100000100010001000001
1000000000010000000000100000100010006000001
1000000000010000000000100000100010001000001
1000000000010000000000100000100010001000001   
1111111111111111111111111111111111111111111